111111111111111111111111111111
1000C0000000000C00000000000C01
1010010110E1100010100100C00001
101C01C01X10100001C01001000001
1P000C0000101000C000000100C001
111111111111111111111111111111
