11111111111111111111111
1C0000011100100C0000E01
10000000000C00000110011
11000100000000011111101
10000100001111000001001
1100000000X111101101001
1C000000000001000101001
10000111001001001011001
11101100001000000000001
1C00010P000C000000C0001
11111111111111111111111
