1111111111111111111
1X000000P00000E0C11
1111111111111111111
