1111111111111111101111111
1C000CE00000C000000000PC1
11X000C000011100010100001
1000000000000000C1C000001
1111111111111111111111111
